21|11|64|64
*********************
*...................*
*.S===============@.*
*.................=.*
*.@===============@.*
*.=.................*
*.@===============@.*
*.................=.*
*.E===============@.*
*...................*
*********************